(muy) bien | (very) good
Buenas noches. | Good evening./Good night.
Buenas tardes. | Good afternoon.
Buenos días. | Good morning.
¿Cómo estás (tú)? | How are you? (informal)
¿Cómo está (usted)? | How are you? (formal)
gracias | thank you
hola | hello
mal | bad
nada | nothing
¿Qué hay de nuevo? | What's new?
¿Qué pasa? | What's happening?
¿Qué tal? | How's it going?
regular | okay
¿Y tú? | And you? (informal)
¿Y usted? | And you? (formal)
¿Cómo se escribe…? | How do you spell…?
¿Cómo te llamas? | What's your name? (informal)
Encantado(a). | Delighted./Pleased to meet you.
Me llamo… | My name is…
Mucho gusto. | Nice to meet you.
Le presento a… | I present to you… (formal)
Te presento a… | I present to you… (informal)
Despedidas | Farewells
Adiós. | Goodbye.
Chao. | Bye.
Hasta luego. | See you later.
Hasta mañana. | See you tomorrow.
Hasta pronto. | See you soon.
¡Nos vemos! | See you!
¡Que tengas un buen día! | Have a good day!
El salón de clases | Classroom
la bandera | flag
el bolígrafo | pen
el cartel | poster
la computadora | computer
el cuaderno | notebook
el diccionario | dictionary
el escritorio | desk
el (la) estudiante | student
el lápiz | pencil
el libro | book
el mapa | map
la mesa | table
la mochila | backpack
el papel | paper
la pizarra | whiteboard
el (la) profesor(a) | teacher
la puerta | door
el pupitre | student desk
el reloj | clock
el salón de clases | classroom
la silla | chair
el televisor | television
la ventana | window
Palabras interrogativas | Interrogative words
¿Dónde? | Where?
¿Cuándo? | When?
¿Cuántos(as)? | How many?
¿Qué? | What?
¿Quién? | Who?
¿Por qué? | Why?
¿De dónde eres tú? | Where are you from? (informal)
hay | there is/there are
Yo soy de… | I am from…
aburrido(a) | boring
agresivo(a) | aggressive
amable | kind
antipático(a) | unfriendly
atlético(a) | athletic
bueno(a) | good
cariñoso(a) | affectionate
cómico(a) | funny
conservador(a) | conservative
cruel | cruel
egoísta | selfish
famoso(a) | famous
generoso(a) | generous
honesto(a) | honest
idealista | idealistic
impaciente | impatient
inteligente | intelligent
interesante | interesting
liberal | liberal
malo(a) | bad
optimista | optimistic
paciente | patient
perezoso(a) | lazy
pesimista | pessimistic
pobre | poor
realista | realistic
rico(a) | rich
serio(a) | serious
simpático(a) | nice
sociable | sociable
tímido(a) | shy
tonto(a) | silly
trabajador(a) | hardworking
alto(a) | tall
bajo(a) | short
bonito(a) | pretty
calvo(a) | bald
delgado(a) | thin
feo(a) | ugly
gordo(a) | fat
grande | big
guapo(a) | good-looking
joven | young
moreno(a) | brunette
pelirrojo(a) | red-haired
pequeño(a) | small
rubio(a) | blond
viejo(a) | old
corto(a) | short
difícil | difficult
fácil | easy
largo(a) | long
nuevo(a) | new
ser | to be
el hombre | man
la mujer | woman
muy | very
el (la) niño(a) | child
pero | but
un poco | a little
también | also
y | and
el (la) abuelo(a) | grandfather (grandmother)
el (la) esposo(a) | husband (wife)
el (la) hermanastro(a) | stepbrother (stepsister)
el (la) hermano(a) | brother (sister)
el (la) hijo(a) | son (daughter)
la madrastra | stepmother
la madre (mamá) | mother (mom)
el (la) medio(a) hermano(a) | half-brother (half-sister)
el (la) nieto(a) | grandson (granddaughter)
el padrastro | stepfather
el padre (papá) | father (dad)
la pareja | partner
el (la) pariente | relative
el (la) primo(a) | cousin
el (la) sobrino(a) | nephew (niece)
el (la) suegro(a) | father-in-law (mother-in-law)
el (la) tío(a) | uncle (aunt)
el caballo | horse
el (la) gato(a) | cat
el pájaro | bird
el (la) perro(a) | dog
el pez | fish
el ratón | mouse
ayudar | to help
bailar | to dance
buscar | to look for
caminar | to walk
cantar | to sing
cocinar | to cook
comprar | to buy
desear | to wish
enseñar | to teach
escuchar | to listen
esquiar | to ski
estudiar | to study
hablar (por teléfono) | to talk (on the phone)
limpiar | to clean
llamar | to call
llegar (a) | to arrive (at)
mandar (un mensaje) | to send (a message)
manejar | to drive
mirar (la tele) | to watch (TV)
nadar | to swim
necesitar | to need
practicar (deportes) | to practice (sports)
preguntar | to ask
regresar | to return
tomar (café) | to drink (coffee)
trabajar | to work
usar | to use
viajar (a) | to travel (to)
el (la) (mejor) amigo(a) | (best) friend
la casa | house
¿Cómo se llama…? | What is …'s name?
la mascota | pet
el (la) novio(a) | boyfriend (girlfriend)
el alemán | German
el álgebra | algebra
el arte | art
la biología | biology
el cálculo | calculus
las ciencias naturales | natural sciences
las ciencias políticas | political sciences
las ciencias sociales | social sciences
la criminología | criminology
la economía | economics
la educación física | physical education
el español | Spanish
la expresión oral | oral expression
la filosofía | philosophy
la física | physics
el francés | French
la geografía | geography
la geometría | geometry
la historia | history
las humanidades | humanities
la informática | computer science
la ingeniería | engineering
el inglés | English
las lenguas | languages
la literatura | literature
las matemáticas | mathematics
la música | music
los negocios | business
el periodismo | journalism
la psicología | psychology
la química | chemistry
la redacción | writing
el teatro | theater
la veterinaria | veterinary science
el auditorio | auditorium
la biblioteca | library
la cafetería | cafeteria
el centro estudiantil | student center
el estadio | stadium
el gimnasio | gym
el laboratorio | laboratory
la librería | bookstore
la residencia estudiantil | dormitory
tener… años | to be… years old
tener (mucho) calor | to be (very) hot
tener (mucho) cuidado | to be (very) careful
tener (mucho) éxito | to be (very) successful
tener (mucho) frío | to be (very) cold
tener ganas de + infinitive | to feel like (doing something)
tener (mucha) hambre | to be (very) hungry
tener (mucho) miedo | to be (very) afraid
tener (mucha) prisa | to be in a (big) hurry
tener que + infinitive | to have to (do something)
tener (mucha) razón | to be (very) right
tener (mucha) sed | to be (very) thirsty
tener (mucho) sueño | to be (very) sleepy
tener (mucha) suerte | to be (very) lucky
la carrera | major
el (la) compañero(a) de clase | classmate
el examen (los exámenes) | exam (exams)
mucho | a lot
la nota | grade
poco | a little
el semestre | semester
la tarea | homework
el trimestre | trimester
varios | several
el abrigo | coat
la blusa | blouse
los bluyines | jeans
la bolsa | bag
las botas | boots
la bufanda | scarf
los calcetines | socks
la camisa | shirt
la camiseta | t-shirt
la chaqueta | jacket
la corbata | tie
la falda | skirt
el gorro | hat
los guantes | gloves
el impermeable | raincoat
los lentes | glasses
los pantalones | pants
los pantalones cortos | shorts
el paraguas | umbrella
el/la pijama | pajamas
las sandalias | sandals
el sombrero | hat
el suéter | sweater
los tenis | sneakers
el traje | suit
el traje de baño | swimsuit
el vestido | dress
los zapatos | shoes
Está despejado. | It's clear.
Está nublado. | It's cloudy.
Hace buen tiempo. | The weather is nice.
Hace calor. | It's hot.
Hace fresco. | It's cool.
Hace frío. | It's cold.
Hace mal tiempo. | The weather is bad.
Hace sol. | It's sunny.
Hace viento. | It's windy.
Llueve. | It's raining.
Nieva. | It's snowing.
el invierno | winter
el otoño | fall
la primavera | spring
el verano | summer
abrir | to open
aprender (a + infinitive) | to learn (to do something)
asistir (a) | to attend
beber | to drink
comer | to eat
comprender | to understand
correr | to run
creer | to believe
deber | to owe/should
decidir | to decide
escribir | to write
leer (un periódico) | to read (a newspaper)
recibir (un regalo) | to receive (a gift)
vender | to sell
vivir | to live
amarillo(a) | yellow
anaranjado(a) | orange
azul | blue
blanco(a) | white
café | brown
gris | gray
morado(a) | purple
negro(a) | black
rojo(a) | red
rosado(a) | pink
verde | green
cómodo(a) | comfortable
llevar | to carry
llevar puesto(a) | to wear
el lunes | Monday
el martes | Tuesday
el miércoles | Wednesday
el jueves | Thursday
el viernes | Friday
el sábado | Saturday
el domingo | Sunday
enero | January
febrero | February
marzo | March
abril | April
mayo | May
junio | June
julio | July
agosto | August
septiembre | September
octubre | October
noviembre | November
diciembre | December
ir | to go
ir de compras | to go shopping
ir de excursión | to go on a hike
ir de paseo | to go for a walk
ir de vacaciones | to go on vacation
terminar | to finish
ahora | now
el Año Nuevo | New Year
el cumpleaños | birthday
el día | day
el día feriado | holiday
la fecha | date
el fin de semana | weekend
hoy | today
mañana | tomorrow
la medianoche | midnight
el mediodía | noon
la Navidad | Christmas
la semana | week
por la mañana | in the morning
por la tarde | in the afternoon
por la noche | at night
todos los días | every day
el aeropuerto | airport
el banco | bank
el bar | bar
el café | café
la calle | street
el centro comercial | shopping center
el cine | cinema
el club | club
el correo | post office
el edificio | building
la escuela | school
la farmacia | pharmacy
el hospital | hospital
el hotel | hotel
la iglesia | church
el mercado | market
la mezquita | mosque
el museo | museum
el negocio | business
la oficina | office
el parque | park
la piscina | pool
la playa | beach
la plaza | plaza
el restaurante | restaurant
la sinagoga | synagogue
el supermercado | supermarket
el teatro | theater
el templo | temple
la tienda | store
el zoológico | zoo
almorzar (ue) | to have lunch
costar (ue) | to cost
depositar | to deposit
devolver (ue) | to return (something)
dormir (ue) | to sleep
encontrar (ue) | to find
estar | to be
jugar (ue) | to play
llover (ue) | to rain
mandar una carta/un paquete | to send a letter/a package
morir (ue) | to die
poder (ue) | to be able to
rezar | to pray
soñar (ue) (con) | to dream (about)
volver (ue) | to return
la carta | letter
la comida | food
el dinero | money
el paquete | package
la película | movie
a la derecha de | to the right of
a la izquierda de | to the left of
al lado de | next to
cerca de | near
debajo de | under
dentro de | inside
detrás de | behind
en | in/on
encima de | on top of
enfrente de | in front of
entre | between
fuera de | outside of
lejos de | far from
el baño | bathroom
la cochera | garage
la cocina | kitchen
el comedor | dining room
el dormitorio | bedroom
el jardín | garden
el patio | patio
la sala | living room
la alfombra | rug
el armario | closet
la bañera | bathtub
la cafetera | coffee maker
la cama | bed
las cortinas | curtains
el cuadro | painting
la ducha | shower
el espejo | mirror
la estufa | stove
la flor | flower
el fregadero | sink
el horno | oven
el (horno de) microondas | microwave
el inodoro | toilet
la lámpara | lamp
el lavabo | sink
la lavadora | washing machine
el lavaplatos | dishwasher
la mesita | small table
las plantas | plants
el refrigerador | refrigerator
la secadora | dryer
el sillón | armchair
el sofá | sofa
alquilar | to rent
cerrar (ie) | to close
comenzar (ie) (a) | to begin (to)
competir (i) | to compete
empezar (ie) (a) | to begin (to)
encender | to turn on
entender (ie) | to understand
mentir (ie) | to lie
nevar (ie) | to snow
pedir (i) | to ask for
pensar (ie) | to think
perder | to lose
preferir (ie) | to prefer
reír (i) | to laugh
repetir (i) | to repeat
querer (ie) | to want
servir (i) | to serve
sonreír (i) | to smile
el apartamento | apartment
la dirección | address
la habitación | room
el mueble | piece of furniture
la planta baja | ground floor
el (primer) piso | (first) floor
¿adónde? | where to?
¿cómo? | how?
¿cuál(es)? | which?
¿cuándo? | when?
¿cuánto(a)? | how much?
¿cuántos(as)? | how many?
¿de dónde? | from where?
¿dónde? | where?
¿por qué? | why?
¿qué? | what?
¿quién(es)? | who?
aburrido(a) | bored
alegre | happy
asustado(a) | scared
avergonzado(a) | embarrassed
cansado(a) | tired
celoso(a) | jealous
confundido(a) | confused
contento(a) | happy
deprimido(a) | depressed
emocionado(a) | excited
enamorado(a) (de) | in love (with)
enfermo(a) | sick
enojado(a) | angry
equivocado(a) | wrong
feliz | happy
frustrado(a) | frustrated
interesado(a) | interested
loco(a) | crazy
nervioso(a) | nervous
ocupado(a) | busy
preocupado(a) | worried
sano(a) | healthy
seguro(a) | sure
sorprendido(a) | surprised
triste | sad
la salud | health
estar listo(a) | to be ready
ser listo(a) | to be clever
estar de acuerdo | to agree
el (la) abogado(a) | lawyer
el actor | actor
la actriz | actress
el (la) agente de viajes | travel agent
el amo(a) de casa | homemaker
el (la) arquitecto(a) | architect
el (la) asistente de vuelo | flight attendant
el bailarín/la bailarina | dancer
el (la) cantante | singer
el (la) científico(a) | scientist
el (la) cocinero(a) | cook
el (la) consejero(a) | counselor
el (la) contador(a) | accountant
el (la) dependiente | clerk
el (la) deportista | athlete
el (la) diseñador(a) | designer
el (la) enfermero(a) | nurse
el (la) escritor(a) | writer
el (la) fotógrafo(a) | photographer
el (la) ingeniero(a) | engineer
el jefe/la jefa | boss
el (la) maestro(a) | teacher
el (la) mecánico(a) | mechanic
el (la) médico(a) | doctor
el (la) mesero(a) | waiter (waitress)
el (la) modelo | model
el (la) músico(a) | musician
el (la) periodista | journalist
el (la) piloto | pilot
el (la) pintor(a) | painter
el policía/la mujer policía | police officer
el (la) político(a) | politician
el (la) psicólogo(a) | psychologist
el (la) secretario(a) | secretary
el (la) trabajador(a) social | social worker
el (la) vendedor(a) | salesperson
el (la) veterinario(a) | veterinarian
el (la) cliente | client
la entrevista | interview
la solicitud | application
el sueldo | salary
el trabajo | work
conducir | to drive
conocer | to know
dar | to give
decir (i) | to say
ganar | to earn
hacer | to do/make
hacer la cama | to make the bed
hacer ejercicio | to exercise
hacer una fiesta | to have a party
hacer una pregunta | to ask a question
hacer la tarea | to do homework
hacer un viaje | to take a trip
oír | to hear
poner | to put
saber | to know
salir | to leave
seguir (i) | to follow
traer | to bring
venir (ie) | to come
ver | to see
acostarse (ue) | to go to bed
afeitarse | to shave
arreglarse | to get ready
bañarse | to take a bath
cepillarse | to brush
despertarse (ie) | to wake up
divertirse (ie) | to have fun
dormirse (ue) | to fall asleep
ducharse | to take a shower
estirarse | to stretch
irse | to leave
lavarse | to wash
levantarse | to get up
maquillarse | to put on makeup
peinarse | to comb
ponerse (la ropa) | to put on (clothes)
quitarse (la ropa) | to take off (clothes)
secarse | to dry
sentarse (ie) | to sit down
verse | to see oneself
vestirse (i) | to get dressed
la boca | mouth
el brazo | arm
la cabeza | head
la cara | face
el codo | elbow
el cuello | neck
el dedo | finger
el dedo (del pie) | toe
el diente | tooth
la espalda | back
el estómago | stomach
el hombro | shoulder
la mano | hand
el muslo | thigh
la nariz | nose
el ojo | eye
la oreja | ear
el pecho | chest
el pelo | hair
el pie | foot
la pierna | leg
la rodilla | knee
el tobillo | ankle
a menudo | often
a veces | sometimes
ahora | now
antes de + infinitive | before (doing something)
después de + infinitive | after (doing something)
hoy | today
luego | later
mañana | tomorrow
más tarde | later
mientras | while
normalmente | normally
(casi) nunca | (almost) never
pronto | soon
(casi) siempre | (almost) always
todavía | still
todos los días | every day
ya | already
ya no | no longer
el cepillo (de dientes) | brush (toothbrush)
el champú | shampoo
el cuerpo | body
el despertador | alarm clock
el jabón | soap
la pasta de dientes | toothpaste
tarde | late
temprano | early
la toalla | towel
el alpinismo | mountaineering
el atletismo | track and field
el bádminton | badminton
el básquetbol | basketball
el béisbol | baseball
el fútbol | soccer
el fútbol americano | football
el golf | golf
la natación | swimming
el tenis | tennis
el voleibol | volleyball
el equipo | team
los patines | skates
la pelota | ball
la raqueta | racket
la red | net
el saco de dormir | sleeping bag
la tienda de campaña | tent
acampar | to camp
andar en bicicleta | to ride a bike
bucear | to scuba dive
esquiar en el agua | to water ski
esquiar en tabla | to snowboard
hacer alpinismo | to go mountaineering
ir de excursión | to go on a hike
ir de pesca | to go fishing
jugar al ping-pong | to play ping-pong
levantar pesas | to lift weights
montar a caballo | to ride a horse
patinar | to skate
patinar en hielo | to ice skate
pescar | to fish
el (la) aficionado(a) | fan
anoche | last night
ayer | yesterday
el campo | field
la cancha | court
la entrada | ticket
el (la) jugador(a) | player
el lago | lake
el partido | match/game
la semana pasada | last week
el durazno | peach
la fresa | strawberry
la manzana | apple
el melón | melon
la naranja | orange
la piña | pineapple
el plátano | banana
la sandía | watermelon
las uvas | grapes
el brócoli | broccoli
la cebolla | onion
la lechuga | lettuce
el maíz | corn
la papa | potato
el pepino | cucumber
el tomate | tomato
la zanahoria | carrot
la crema | cream
la leche | milk
la mantequilla | butter
el queso | cheese
el yogur | yogurt
la catsup | ketchup
el cereal | cereal
el huevo | egg
el jamón | ham
la mayonesa | mayonnaise
la mermelada | jam
la mostaza | mustard
el pan | bread
el pepinillo | pickle
hornear | to bake
el almuerzo | lunch
la cena | dinner
el desayuno | breakfast
frito(a) | fried
los lácteos | dairy products
la rebanada | slice
cien | one hundred
ciento uno | one hundred and one
doscientos | two hundred
trescientos | three hundred
cuatrocientos | four hundred
quinientos | five hundred
seiscientos | six hundred
setecientos | seven hundred
ochocientos | eight hundred
novecientos | nine hundred
mil | one thousand
dos mil | two thousand
un millón | one million
la copa | glass (for wine)
la cuchara | spoon
el cuchillo | knife
el mantel | tablecloth
el plato | plate
la servilleta | napkin
la taza | cup
el tazón | bowl
el tenedor | fork
el vaso | glass
el agua embotellada | bottled water
el arroz | rice
el azúcar | sugar
la bebida | drink
el camarón | shrimp
la carne | meat
el cerdo | pork
la cerveza | beer
el chocolate | chocolate
el coctel | cocktail
la ensalada | salad
el entremés | appetizer
el flan | flan
la hamburguesa | hamburger
el helado | ice cream
el jugo | juice
el pastel | cake
el pavo | turkey
el pescado | fish
la pimienta | pepper
el pollo | chicken
el postre | dessert
la quesadilla | quesadilla
el refresco | soda
la sal | salt
el sándwich | sandwich
la sopa | soup
el té | tea
los totopos | tortilla chips
la vainilla | vanilla
el vino blanco | white wine
el vino tinto | red wine
cenar | to have dinner
dejar (una propina) | to leave (a tip)
desayunar | to have breakfast
felicitar | to congratulate
querer | to want
llevar | to carry
saludar | to greet
al horno | baked
asado(a) | roasted
la comida | meal/food
la cuenta | bill
Me gustaría | I would like
la orden | order
el plato principal | main dish
la basura | trash
el bote de basura | trash can
el cortacésped | lawn mower
la escoba | broom
el jabón para platos | dish soap
la manguera | hose
la plancha | iron
los quehaceres | chores
el sacudidor | duster
la tabla de planchar | ironing board
el trapeador | mop
el trapo | rag
barrer | to sweep
colgar (ue) | to hang
cortar (el césped) | to cut (the grass)
guardar | to put away
hacer la cama | to make the bed
lavar platos | to wash dishes
lavar ropa | to wash clothes
ordenar | to tidy up
pasar la aspiradora | to vacuum
planchar | to iron
poner la mesa | to set the table
recoger (la mesa) | to clear (the table)
regar (ie) | to water
sacar la basura | to take out the trash
sacudir | to dust
secar | to dry
trapear | to mop
desordenado(a) | messy
limpio(a) | clean
ordenado(a) | tidy
sucio(a) | dirty
el ajedrez | chess
el carrito | toy car
las cartas | cards
el chiste | joke
el cuento | story
la cuerda | rope
las damas | checkers
el dominó | dominoes
las escondidas | hide and seek
la historieta | comic strip
el juego de mesa | board game
el juguete | toy
la motocicleta | motorcycle
la (el) muñeca(o) | doll
el osito de peluche | teddy bear
la patineta | skateboard
el rompecabezas | puzzle
el videojuego | video game
aburrir | to bore
andar en | to ride
caer (bien / mal) | to get along (well / badly)
chatear | to chat
contar (ue) | to tell
cuidar a (niños) | to take care of (children)
dibujar | to draw
encantar | to love
fascinar | to fascinate
hacer jardinería | to do gardening
importar | to matter
interesar | to interest
ir de paseo | to go for a walk
jugar a los bolos | to go bowling
jugar a las escondidas | to play hide and seek
molestar | to bother
mostrar (ue) | to show
navegar en Internet | to surf the Internet
pasar tiempo con | to spend time with
pelear | to fight
portarse (bien / mal) | to behave (well / badly)
prestar | to lend
salir a + infinitive | to go out to (do something)
saltar la cuerda | to jump rope
tejer | to knit
tocar (el piano / la guitarra) | to play (the piano / the guitar)
trepar (un árbol) | to climb (a tree)
volar una cometa | to fly a kite
la niñera | babysitter
el permiso | permission
el piano | piano
el (teléfono) celular | cellphone
los banderines | banners
los bocadillos | snacks
el brindis | toast
el champán | champagne
las decoraciones | decorations
el desfile | parade
los dulces | sweets
el festejo | celebration
los fuegos artificiales | fireworks
los globos | balloons
el grupo de música | music group
la invitación | invitation
el invitado | guest
los novios | bride and groom
el pastel | cake
la piñata | piñata
la quinceañera | quinceañera
el regalo | gift
la serenata | serenade
la vela | candle
el aniversario | anniversary
el bautizo | baptism
la boda | wedding
la graduación | graduation
las posadas | Christmas processions
los quince años | fifteenth birthday
el santo | saint's day
besar | to kiss
brindar | to make a toast
casarse (con) | to get married (to)
celebrar | to celebrate
cumplir años | to have a birthday
decorar | to decorate
disfrutar | to enjoy
escoger | to choose
romper | to break
terminar | to finish
la acera | sidewalk
la ambulancia | ambulance
la camilla | stretcher
la carretera | highway
el (la) ciclista | cyclist
el coche | car
el (la) conductor(a) | driver
el cruce | crossing
la esquina | corner
el límite de velocidad | speed limit
la multa | fine
el paramédico | paramedic
el parquímetro | parking meter
la patrulla | patrol car
el peatón (la peatona) | pedestrian
el poste | pole
el puente | bridge
el semáforo | traffic light
la señal | sign
el servicio de emergencia | emergency service
el (la) testigo | witness
aburrirse | to get bored
alegrarse | to become happy
asustarse | to get scared
atravesar (ie) | to cross
atropellar | to run over
bajar de | to get off
caer(se) | to fall
chocar (con) | to crash (into)
cruzar | to cross
dañar | to damage
distraerse | to get distracted
enojarse | to get angry
esperar | to wait
estacionarse | to park
frustrarse | to get frustrated
pararse | to stop
pasarse un semáforo en rojo | to run a red light
pasarse una señal de PARE | to run a stop sign
sentirse | to feel
sorprenderse | to be surprised
subir a | to get on
tropezar (ie) | to trip
de repente | suddenly
estar dañado(a) | to be damaged
estar herido(a) | to be injured
a tiempo | on time
la aduana | customs
el asiento | seat
el boleto | ticket
la clase turista | economy class
la conexión | connection
el equipaje | luggage
el equipaje de mano | carry-on luggage
la estación de autobuses | bus station
la llegada | arrival
el (la) pasajero(a) | passenger
el pasillo | aisle
el pasaporte | passport
la primera clase | first class
retrasado(a) | delayed
la sala de espera | waiting room
la salida | departure
la ventanilla | window
el aeropuerto internacional | international airport
el (la) agente de seguridad | security agent
el cinturón de seguridad | seatbelt
la escala | layover
la maleta | suitcase
el mostrador | counter
el pase de abordar | boarding pass
la puerta (de salida) | (departure) gate
el reclamo de equipaje | baggage claim
la revisión de equipaje | baggage inspection
la visa | visa
el vuelo | flight
el andén | platform
el coche cama | sleeper car
la litera | bunk bed
la parada | stop
el (la) revisor(a) | ticket inspector
la taquilla | ticket office
el vagón | train car
abordar | to board
aterrizar | to land
despegar | to take off
doblar | to turn
facturar equipaje | to check luggage
pasar por seguridad | to go through security
perder | to lose
seguir derecho | to go straight
el alojamiento | lodging
el ascensor | elevator
el (la) botones | bellhop
el (la) camarero(a) | waiter/waitress
el centro de negocios | business center
las escaleras | stairs
el (la) gerente | manager
el (la) huésped | guest
el Internet inalámbrico | wireless Internet
la llave | key
la recepción | reception desk
el (la) recepcionista | receptionist
la sala de conferencias | conference room
el sauna | sauna
el servicio a la habitación | room service
el transporte | transportation
el (la) turista | tourist
alojarse | to stay
bajar | to go down
hacer el check out | to check out
quedarse | to stay
registrarse | to check in
subir | to go up
disponible | available
(la habitación) doble | double room
de lujo | luxury
(la habitación) sencilla | single room
(la habitación) triple | triple room
la caja | cash register
el (dinero en) efectivo | cash
el número | size (shoes)
el probador | fitting room
la tarjeta de crédito | credit card
las telas | fabrics
el algodón | cotton
la lana | wool
el lino | linen
la mezclilla | denim
la piel | leather
la seda | silk
a cuadros | checkered
a rayas | striped
de lunares | polka-dotted
estampado(a) | patterned
liso(a) | plain
ahorrar | to save (money)
elegir (i) | to choose
hacer juego | to match
probarse (ue) | to try on
quedar | to fit
apretado(a) | tight
barato(a) | cheap
caro(a) | expensive
cómodo(a) | comfortable
de marca | branded
(estar) a la moda | to be in style
(estar) rebajado(a) | to be on sale
(extra) grande | extra large
hecho(a) a mano | handmade
liso(a) | plain
mediano(a) | medium
pequeño(a) | small
¡Qué bien te queda esa falda! | That skirt looks great on you!
¡Qué caros! | How expensive!
¡Qué color tan bonito! | What a beautiful color!
¡Qué lindos zapatos! | What beautiful shoes!
¡Qué pantalones tan elegantes! | What elegant pants!
mayor | older/greater
mejor | better
menor | younger/lesser
peor | worse
el descuento | discount
la oferta | sale
por ciento | percent
la prenda | garment
la talla | size (clothes)
la venta | sale
el arte abstracto | abstract art
el (la) artista | artist
el autorretrato | self-portrait
la escultura | sculpture
la exhibición | exhibition
la galería | gallery
el grabado | engraving
la luz | light
la máscara | mask
el (la) modelo | model
el mural | mural
la naturaleza muerta | still life
la obra | work of art
el óleo | oil painting
el paisaje | landscape
la paleta | palette
el pincel | paintbrush
la pintura | painting
el retrato | portrait
la tinta | ink
acabar | to finish
apagar | to turn off
apreciar | to appreciate
descomponer | to break down
diseñar | to design
esculpir | to sculpt
exhibir | to exhibit
olvidar | to forget
pintar | to paint
posar | to pose
quedar | to stay
romper | to break
abstracto(a) | abstract
claro(a) | light
complicado(a) | complicated
cubista | cubist
extraño(a) | strange
impresionista | impressionist
obscuro(a) | dark
realista | realistic
sencillo(a) | simple
surrealista | surrealist
tradicional | traditional
vanguardista | avant-garde
el árbol | tree
la arena | sand
el cactus | cactus
el cambio climático | climate change
la cascada | cascade
la catarata | waterfall
el cielo | sky
la contaminación | pollution
la deforestación | deforestation
los desechos industriales | industrial waste
la ecología | ecology
el esmog | smog
la naturaleza | nature
la nube | cloud
la ola | wave
la palmera | palm tree
el pasto | grass
el petróleo | oil
el reciclaje | recycling
los recursos naturales | natural resources
rodeado(a) por | surrounded by
el volcán | volcano
la bahía | bay
el bosque | forest
la colina | hill
la costa | coast
el desierto | desert
la isla | island
el llano | plain
el mar | sea
la montaña | mountain
la pampa | plain
la península | peninsula
el río | river
la selva | jungle
la Tierra | Earth
el valle | valley
destruir | to destroy
hacer erupción | to erupt
preservar | to preserve
proteger | to protect
reciclar | to recycle
el águila (f.) | eagle
la ardilla | squirrel
la ballena | whale
la cebra | zebra
el cerdo | pig
el cocodrilo | crocodile
el conejo | rabbit
el elefante | elephant
la gallina | hen
el gallo | rooster
el gorila | gorilla
el jaguar | jaguar
la jirafa | giraffe
el león | lion
la llama | llama
el lobo | wolf
el mono | monkey
el oso | bear
la oveja | sheep
el pato | duck
el pavo | turkey
el pingüino | penguin
el pollo | chicken
la rana | frog
la serpiente | snake
el tiburón | shark
el tigre | tiger
el toro | bull
la tortuga | turtle
la vaca | cow
el venado | deer
el zorro | fox
los anfibios | amphibians
las aves | birds
los mamíferos | mammals
los peces | fish
los reptiles | reptiles
cazar | to hunt
la caza | hunting
domesticado(a) | domesticated
la granja | farm
la hembra | female
la jaula | cage
el macho | male
estar en peligro de extinción | to be endangered
salvaje | wild
el anillo | ring
las bodas de oro | golden anniversary
las bodas de plata | silver anniversary
la ceremonia | ceremony
la cita | date
el compromiso | engagement
el divorcio | divorce
el estado civil | marital status
la luna de miel | honeymoon
la madrina | godmother
el noviazgo | courtship
el padrino | godfather
la pareja | couple
el (la) prometido(a) | fiancé(e)
la recepción | reception
el (la) recién casado(a) | newlywed
soltero(a) | single
la unión libre | living together
viudo(a) | widowed
abrazar | to hug
amar | to love
comprometerse (con) | to get engaged (to)
dar a luz | to give birth
desear | to wish
divorciarse (de) | to divorce
enamorarse (de) | to fall in love (with)
esperar | to wait
estar embarazada | to be pregnant
extrañar (a) | to miss
insistir (en) | to insist (on)
llevarse (bien/mal) | to get along (well/badly)
mandar | to send
nacer | to be born
odiar | to hate
proponer matrimonio | to propose marriage
querer | to want
romper (con) | to break up (with)
separarse (de) | to separate (from)
sugerir (ie) | to suggest
la adolescencia | adolescence
la juventud | youth
la madurez | maturity
la muerte | death
el nacimiento | birth
la niñez | childhood
la vejez | old age
la comedia | comedy
el drama | drama
el documental | documentary
la telenovela | soap opera
el programa de horror | horror program
el programa de misterio | mystery program
el programa deportivo | sports program
el programa de telerrealidad | reality show
la audiencia (infantil) | (children's) audience
el conductor | host
el control remoto | remote control
el documental | documentary
los dibujos animados | cartoons
el (la) locutor(a) | announcer
el noticiario | news program
el programa de concursos | game show
el reproductor de DVD | DVD player
la telenovela | soap opera
el televidente | viewer
la aplicación | app
los audífonos | headphones
el buscador | search engine
el MP3 | MP3 player
la pantalla | screen
el ratón | mouse
las redes sociales | social media
el teclado | keyboard
la tableta | tablet
la butaca | armchair
el éxito de taquilla | blockbuster
las golosinas | candies
las palomitas de maíz | popcorn
censurar | to censor
chatear | to chat
hacer clic (en) | to click (on)
limitar | to limit
temer | to fear
transmitir | to broadcast
transmitir en directo | to live-stream
el (la) adolescente | teenager
el (la) adulto(a) | adult
el canal | channel
la clasificación | rating
la revista | magazine
el corazón | heart
el esqueleto | skeleton
el hueso | bone
las muletas | crutches
el órgano vital | vital organ
el (la) paciente | patient
los primeros auxilios | first aid
los pulmones | lungs
la radiografía | X-ray
la sala de emergencias | emergency room
la salud | health
la sangre | blood
el seguro | insurance
la silla de ruedas | wheelchair
el yeso | cast
la alergia | allergy
la cortada | cut
la diarrea | diarrhea
el dolor (de) | pain (in)
la presión baja/alta | low/high blood pressure
el cáncer | cancer
la diabetes | diabetes
la gripe | flu
la hipertensión | hypertension
el insomnio | insomnia
el resfriado | cold
la aspirina | aspirin
la cirugía | surgery
la curita | adhesive bandage
las gotas | drops
la inyección | injection
el jarabe | syrup
la pastilla | pill
la receta médica | prescription
la vacuna | vaccine
el vendaje | bandage
dejar de fumar | to quit smoking
descansar | to rest
desmayarse | to faint
doler (ue) | to hurt
enfermarse | to get sick
estar mareado(a) | to feel dizzy
estar congestionado(a) | to be congested
estornudar | to sneeze
examinar | to examine
fracturarse | to fracture
recuperarse | to recover
respirar | to breathe
sentir náuseas | to feel nauseous
tomar la presión | to take blood pressure
toser | to cough
argentino(a) | Argentinian
boliviano(a) | Bolivian
chileno(a) | Chilean
colombiano(a) | Colombian
costarricense | Costa Rican
cubano(a) | Cuban
dominicano(a) | Dominican
ecuatoguineano(a) | Equatorial Guinean
ecuatoriano(a) | Ecuadorian
español(a) | Spanish
guatemalteco(a) | Guatemalan
hondureño(a) | Honduran
mexicano(a) | Mexican
nicaragüense | Nicaraguan
panameño(a) | Panamanian
paraguayo(a) | Paraguayan
peruano(a) | Peruvian
puertorriqueño(a) | Puerto Rican
salvadoreño(a) | Salvadoran
uruguayo(a) | Uruguayan
venezolano(a) | Venezuelan
la beca | scholarship
el choque cultural | culture shock
el (la) ciudadano(a) | citizen
la embajada | embassy
el gobierno | government
el idioma | language
el organismo internacional | international organization
el país | country
el pasaporte | passport
acostumbrarse (a) | to get used to
asimilarse | to assimilate
emigrar | to emigrate
establecerse | to settle
extrañar | to miss
inmigrar | to immigrate
mejorar | to improve
migrar | to migrate
mudarse | to move
bilingüe | bilingual
extranjero(a) | foreign
hispanohablante | Spanish-speaking
a fin de que | so that
a menos que | unless
antes (de) que | before
aunque | although
con tal (de) que | provided that
después (de) que | after
en caso de que | in case
en cuanto | as soon as
hasta que | until
para que | so that
siempre y cuando | as long as
sin que | without
tan pronto (como) | as soon as
